NO ./textures/bluestone.xpm
EA ./textures/eagle.xpm
C 255,255,255
WE ./textures/greystone.xpm
SO ./textures/redbrick.xpm
F   255 , 255,  255

111111
100101
101001
1100N1
111111
