C200,99,0
F0,99,200
NO./textures/bluestone.xpm
SO./textures/bluestone.xpm
WE./textures/bluestone.xpm
EA./textures/bluestone.xpm
  11111
 10011111
 10101  01
 11N011111
  1100001
    1111