NO ./textures/bluestone.xpm
EA ./textures/eagle.xpm
C 225,30,0
WE ./textures/greystone.xpm
F   255 , 0 , 255
SO


111111
100101
101001
1100N1
111111
