NO ./textures/bluestone.xpm
EA ./textures/eagle.xpm
WE ./textures/greystone.xpm
SO ./textures/redbrick.xpm
F   255 , 0 , 255
C 225,30,0

111111
100100
101001
1100N1
111111
